Index,X,Y,Color
0,0,0,0
1,1,0,0
2,0,1,0
3,1,1,0
4,2,0,1
5,3,0,1
6,2,1,1
7,3,1,1
8,4,0,2
9,5,0,2
10,4,1,2
11,5,1,2
12,6,0,1
13,7,0,1
14,6,1,1
15,0,2,2
16,1,2,2
17,0,3,2
18,1,3,2
19,2,2,0
20,3,2,0
21,2,3,0
22,3,3,0
23,4,2,1
24,5,2,1
25,4,3,1
26,5,3,1
27,6,2,0
28,7,2,0
29,6,3,0
